NO includes/textures/wallbluearcade.xpm
SO includes/textures/wallbluearcade.xpm
EA includes/textures/wallbluearcade.xpm
WE includes/textures/wallbluearcade.xpm

F 0,97,167
C 204,233,251

1111111      1111111
10000011111111000001
10E00000000000000001
10000000000000000001
10000011100111000001
11001110000001110011
 100000000000000001
 100000001100000001
 100000000000000001
11001110000001110011
10000011100111000001
10000000000000000001
10000000000000000001
10000011111111000001
1111111      1111111