NO includes/textures/wallbluearcade.xpm
SO tx/PS.xpm
WE tx/GW.xpm
EA tx/GE.xpm

F 0,255,255
C 255, 0, 0

11111
10001
10E01
11111