NO includes/textures/wallbluearcade.xpm
SO includes/textures/wallbluearcade.xpm
WE includes/textures/wallbluearcade.xpm
EA includes/textures/wallbluearcade.xpm

F 0,0,200
C 0,0,200

111111111
100011111
10S011111
100011111
111100011
111100011
111100011
111111111
