NO includes/textures/wallbluearcade.xpm
EA tx/E.xpm
SO tx/S.xpm
WE tx/WE.xpm

F 0,255,255
C 255, 0, 0

11111
10001
10S01
10001
11111