NO includes/textures/wallbluearcade.xpm



SO includes/textures/wallbluearcade.xpm


EA includes/textures/wallbluearcade.xpm



WE includes/textures/wallbluearcade.xpm



F 0,0,200
C 0,0,200

1111111
1000001
1000001
1000001
100000N
1000001
1000001
1111111
