1111
1N01
1111

NO includes/textures/wallbluearcade.xpm
SO includes/textures/wallbluearcade.xpm
WE includes/textures/wallbluearcade.xpm
EA includes/textures/wallbluearcade.xpm

F 0,0,200
C 0,0,200