NOincludes/textures/wallbluearcade.xpm
SO includes/textures/wallbluearcade.xpm
WE includes/textures/wallbluearcade.xpm
EA includes/textures/wallbluearcade.xpm

F   231   ,  ,   13,         255          
C 0, 123 , 200 

11111111111111111111111
10000000000100000000001
10000000001000000000001
10000000010100000N00001
10000000001000000000001
10000000000000000000001
10000000000100000000001
11111111111111111111111