NO includes/textures/wallbluearcade.xpm
SO includes/textures/wallbluearcade.xpm     
WE includes/textures/wallbluearcade.xpm



EA includes/textures/wallbluearcade.xpm






F 000250   ,         2      555555545     , 255  
C 0, 23 , 200 

1111111111
101N0011          1
10000001
10000001
10000001
10000001
10000001
1111111111