NO     ./includes/textures/emptywall.xpm
SO ./includes/textures/wallbluearcade.xpm
WE ./includes/textures/emptywall.xpm
EA ./includes/textures/emptywall.xpm

F 40, 251, 1
C 1, 5, 1

        1111111111
        1111111111
111111111111111111
100000000000000001
100000000000000001
100000000000000001
100000000000000001
100000000000000001
100000000000000001
100000000000000001
1000000000000000001
10000000W0000000011
10000000000000000001
1111111111111111111
