NO ./includes/textures/emptywall.xpm
SO ./includes/textures/wallbluearcade.xpm
WE ./includes/textures/no.xpm
EA ./includes/textures/emptywall.xpm

F 40, 40, 65
C 0, 0, 50

111111111111111111111111
1000000000110000000000001
1N1100000111000000000001
10010000000000000000000011111111
111111111011000001110000000000001
10000000001100000111011110000011
1111011111111101110000001000001
1111011111111101110101001000001
1100000011010101110000001000001
100000000000000110000001000001
1000000000000000110101001000001
100000111010101111101111000111
 1110111 1110101 101111010001
 111111   11111   11111111111